Type,Product,Started Date,Completed Date,Description,Amount,Fee,Currency,State,Balance
EXCHANGE,Current,2024-01-02 10:11:40,2024-01-02 10:11:40,Exchange to SEK,5000.00,0.00,SEK,COMPLETED,5000.00
TRANSFER,Current,2024-01-02 10:12:27,2024-01-02 10:14:36,Transfer to Revolut user,-5000.00,0.00,SEK,COMPLETED,0.00
EXCHANGE,Current,2024-01-05 15:59:34,2024-01-05 15:59:34,Exchange to SEK,5000.00,0.00,SEK,COMPLETED,5000.00
TRANSFER,Current,2024-01-05 15:59:45,2024-01-05 15:59:46,Transfer to Revolut user,-5000.00,0.00,SEK,COMPLETED,0.00
CARD_CREDIT,Current,2024-01-07 20:08:09,2024-01-07 20:08:09,Spooniker,3346.00,0.00,SEK,COMPLETED,3346.00
EXCHANGE,Current,2024-01-08 14:03:21,2024-01-08 14:03:21,Exchange to EUR,-146.00,0.00,SEK,COMPLETED,3200.00
TRANSFER,Current,2024-01-08 14:02:59,2024-01-09 09:39:08,International Transfer,-3200.00,0.00,SEK,COMPLETED,0.00
EXCHANGE,Current,2024-01-11 18:22:29,2024-01-11 18:22:29,Exchange to SEK,600.00,0.00,SEK,COMPLETED,600.00
TRANSFER,Current,2024-01-11 21:19:07,2024-01-11 21:19:08,Transfer to Revolut user,-600.00,0.00,SEK,COMPLETED,0.00
REWARD,Current,2024-01-12 21:37:03,2024-01-12 21:37:03,Referral reward,700.00,0.00,SEK,COMPLETED,700.00
EXCHANGE,Current,2024-01-14 14:59:16,2024-01-14 14:59:16,Exchange to SEK,22.48,0.22,SEK,COMPLETED,722.26
TRANSFER,Current,2024-01-14 15:00:58,2024-01-14 15:00:58,Transfer to Revolut user,-374.00,0.00,SEK,COMPLETED,348.26
CARD_PAYMENT,Current,2024-01-12 23:52:57,2024-01-15 11:23:29,Brooklyn Craft,-33.90,0.34,SEK,COMPLETED,314.02
TOPUP,Current,2024-01-15 13:18:27,2024-01-15 13:18:48,Top-Up by *7097,1471.00,0.00,SEK,COMPLETED,1785.02
EXCHANGE,Current,2024-01-15 16:25:13,2024-01-15 16:25:13,Exchange to EUR,-1404.80,0.00,SEK,COMPLETED,380.22
CARD_PAYMENT,Current,2024-01-13 18:59:22,2024-01-15 17:32:25,El Corte Inglés,-99.43,0.99,SEK,COMPLETED,279.80
CARD_PAYMENT,Current,2024-01-13 11:18:48,2024-01-15 17:50:16,Glovo,-211.05,2.11,SEK,COMPLETED,66.64
CARD_PAYMENT,Current,2024-01-15 14:16:41,2024-01-16 11:42:57,Tabacos 58,-66.64,0.00,SEK,COMPLETED,0.00
TOPUP,Current,2024-01-17 17:51:27,2024-01-17 17:51:47,Top-Up by *7097,1153.00,0.00,SEK,COMPLETED,1153.00
EXCHANGE,Current,2024-01-17 17:52:05,2024-01-17 17:52:05,Exchange to EUR,-1153.00,0.00,SEK,COMPLETED,0.00
TRANSFER,Current,2024-01-20 20:50:25,2024-01-20 20:50:25,Transfer from Revolut user,140.00,0.00,SEK,COMPLETED,140.00
EXCHANGE,Current,2024-01-21 18:40:29,2024-01-21 18:40:29,Exchange to EUR,-33.17,0.00,SEK,COMPLETED,106.83
CARD_PAYMENT,Current,2024-01-20 20:54:32,2024-01-22 14:31:22,El Corte Inglés,-106.83,0.00,SEK,COMPLETED,0.00
TOPUP,Current,2024-01-23 13:59:31,2024-01-23 13:59:39,Top-Up by *7097,500.00,0.00,SEK,COMPLETED,500.00
TOPUP,Current,2024-01-23 23:54:41,2024-01-23 23:54:45,Top-Up by *7097,199.00,0.00,SEK,COMPLETED,699.00
EXCHANGE,Current,2024-01-24 05:44:29,2024-01-24 05:44:29,Exchange to EUR,-216.70,0.00,SEK,COMPLETED,482.30
CARD_PAYMENT,Current,2024-01-23 14:25:40,2024-01-24 13:52:12,Sapporet Bar,-59.11,0.00,SEK,COMPLETED,423.19
CARD_PAYMENT,Current,2024-01-23 14:49:18,2024-01-24 13:53:44,Tabacos,-56.83,0.00,SEK,COMPLETED,366.36
CARD_PAYMENT,Current,2024-01-23 15:31:18,2024-01-24 15:06:27,pandadoc.com,-366.36,0.00,SEK,COMPLETED,0.00
TRANSFER,Current,2024-01-25 22:31:43,2024-01-25 22:31:43,Transfer from Revolut user,1300.00,0.00,SEK,COMPLETED,1300.00
EXCHANGE,Current,2024-01-25 22:32:41,2024-01-25 22:32:41,Exchange to SEK,52.45,0.00,SEK,COMPLETED,1352.45
TRANSFER,Current,2024-01-25 22:33:04,2024-01-25 22:33:05,"Revolut Bank UAB, Sucursal en España",-1352.00,0.00,SEK,COMPLETED,0.45
TOPUP,Current,2024-01-28 15:29:49,2024-01-28 15:29:53,Top-Up by *7097,300.00,0.00,SEK,COMPLETED,300.45
EXCHANGE,Current,2024-01-28 15:30:04,2024-01-28 15:30:04,Exchange to EUR,-300.45,0.00,SEK,COMPLETED,0.00
TRANSFER,Current,2024-01-28 15:39:56,2024-01-28 15:39:56,"Revolut Bank UAB, Sucursal en España",2.00,0.00,SEK,COMPLETED,2.00
EXCHANGE,Current,2024-01-28 15:41:11,2024-01-28 15:41:11,Exchange to EUR,-2.00,0.00,SEK,COMPLETED,0.00
TOPUP,Current,2024-01-30 01:26:47,2024-01-30 01:27:11,Top-Up by *7097,2000.00,0.00,SEK,COMPLETED,2000.00
EXCHANGE,Current,2024-01-30 01:27:35,2024-01-30 01:27:35,Exchange to EUR,-2000.00,0.00,SEK,COMPLETED,0.00
TOPUP,Current,2024-02-07 10:02:42,2024-02-07 10:02:47,Top-Up by *7097,120.00,0.00,SEK,COMPLETED,120.00
EXCHANGE,Current,2024-02-07 10:03:16,2024-02-07 10:03:16,Exchange to EUR,-120.00,0.00,SEK,COMPLETED,0.00
TOPUP,Current,2024-02-07 12:57:03,2024-02-07 12:57:08,Top-Up by *7097,300.00,0.00,SEK,COMPLETED,300.00
EXCHANGE,Current,2024-02-07 12:59:03,2024-02-07 12:59:03,Exchange to EUR,-300.00,0.00,SEK,COMPLETED,0.00
TOPUP,Current,2024-02-07 16:34:05,2024-02-07 16:34:12,Top-Up by *7097,120.00,0.00,SEK,COMPLETED,120.00
EXCHANGE,Current,2024-02-07 16:34:19,2024-02-07 16:34:19,Exchange to EUR,-120.00,0.00,SEK,COMPLETED,0.00
TOPUP,Current,2024-02-08 10:31:56,2024-02-08 10:31:58,Top-Up by *7097,365.00,0.00,SEK,COMPLETED,365.00
EXCHANGE,Current,2024-02-08 10:32:24,2024-02-08 10:32:24,Exchange to EUR,-365.00,0.00,SEK,COMPLETED,0.00
TOPUP,Current,2024-02-18 10:46:06,2024-02-18 10:46:14,Top-Up by *7097,200.00,0.00,SEK,COMPLETED,200.00
EXCHANGE,Current,2024-02-18 10:46:37,2024-02-18 10:46:37,Exchange to EUR,-200.00,0.00,SEK,COMPLETED,0.00
TOPUP,Current,2024-02-18 18:13:27,2024-02-18 18:13:30,Top-Up by *7097,900.00,0.00,SEK,COMPLETED,900.00
EXCHANGE,Current,2024-02-18 18:13:41,2024-02-18 18:13:41,Exchange to EUR,-900.00,0.00,SEK,COMPLETED,0.00
TOPUP,Current,2024-02-18 22:43:01,2024-02-18 22:43:06,Top-Up by *7097,600.00,0.00,SEK,COMPLETED,600.00
EXCHANGE,Current,2024-02-18 22:43:18,2024-02-18 22:43:18,Exchange to EUR,-600.00,0.00,SEK,COMPLETED,0.00
TOPUP,Current,2024-02-20 08:45:41,2024-02-20 08:45:44,Top-Up by *7097,1000.00,0.00,SEK,COMPLETED,1000.00
EXCHANGE,Current,2024-02-20 08:45:51,2024-02-20 08:45:51,Exchange to EUR,-1000.00,0.00,SEK,COMPLETED,0.00
TOPUP,Current,2024-02-23 16:26:04,2024-02-23 16:26:10,Top-Up by *7097,1000.00,0.00,SEK,COMPLETED,1000.00
EXCHANGE,Current,2024-02-23 16:26:20,2024-02-23 16:26:20,Exchange to EUR,-1000.00,0.00,SEK,COMPLETED,0.00
EXCHANGE,Current,2024-02-24 23:37:54,2024-02-24 23:37:54,Exchange to SEK,95.48,0.95,SEK,COMPLETED,94.53
CARD_PAYMENT,Current,2024-02-24 23:38:22,2024-02-25 15:57:50,Svenska Spel Sport & Casino,-94.00,0.00,SEK,COMPLETED,0.53
TOPUP,Current,2024-02-29 15:16:10,2024-02-29 15:16:33,Top-Up by *7097,1467.00,0.00,SEK,COMPLETED,1467.53
EXCHANGE,Current,2024-02-29 15:16:47,2024-02-29 15:16:47,Exchange to EUR,-1467.53,0.00,SEK,COMPLETED,0.00
TOPUP,Current,2024-03-09 12:25:26,2024-03-09 12:25:30,Top-Up by *7097,204.00,0.00,SEK,COMPLETED,204.00
EXCHANGE,Current,2024-03-09 12:25:48,2024-03-09 12:25:48,Exchange to EUR,-204.00,0.00,SEK,COMPLETED,0.00
EXCHANGE,Current,2024-03-12 07:45:31,2024-03-12 07:45:31,Exchange to SEK,35.00,0.00,SEK,COMPLETED,35.00
TOPUP,Current,2024-03-12 14:22:43,2024-03-12 14:22:45,Top-Up by *7097,183.00,0.00,SEK,COMPLETED,218.00
EXCHANGE,Current,2024-03-12 14:22:58,2024-03-12 14:22:58,Exchange to EUR,-218.00,0.00,SEK,COMPLETED,0.00
EXCHANGE,Current,2024-03-14 08:57:09,2024-03-14 08:57:09,Exchange to SEK,1500.00,0.00,SEK,COMPLETED,1500.00
TRANSFER,Current,2024-03-14 08:58:35,2024-03-14 08:58:35,Transfer to Revolut user,-900.00,0.00,SEK,COMPLETED,600.00
EXCHANGE,Current,2024-03-14 09:00:20,2024-03-14 09:00:20,Exchange to EUR,-600.00,0.00,SEK,COMPLETED,0.00
TOPUP,Current,2024-03-18 22:02:38,2024-03-18 22:03:03,Top-Up by *7097,2000.00,0.00,SEK,COMPLETED,2000.00
EXCHANGE,Current,2024-03-18 22:06:22,2024-03-18 22:06:22,Exchange to EUR,-2000.00,0.00,SEK,COMPLETED,0.00
TOPUP,Current,2024-04-03 21:03:14,2024-04-03 21:03:22,Top-Up by *7097,936.00,0.00,SEK,COMPLETED,936.00
EXCHANGE,Current,2024-04-03 21:03:33,2024-04-03 21:03:33,Exchange to EUR,-936.00,0.00,SEK,COMPLETED,0.00
TOPUP,Current,2024-04-04 01:02:12,2024-04-04 01:02:17,Top-Up by *7097,270.00,0.00,SEK,COMPLETED,270.00
EXCHANGE,Current,2024-04-04 01:02:27,2024-04-04 01:02:27,Exchange to EUR,-270.00,0.00,SEK,COMPLETED,0.00
TOPUP,Current,2024-04-12 19:23:02,2024-04-12 19:23:08,Top-Up by *7097,1000.00,0.00,SEK,COMPLETED,1000.00
EXCHANGE,Current,2024-04-12 21:48:10,2024-04-12 21:48:10,Exchange to EUR,-645.50,0.00,SEK,COMPLETED,354.50
CARD_PAYMENT,Current,2024-04-12 19:24:30,2024-04-13 12:37:56,Formatgeria,-354.50,0.00,SEK,COMPLETED,0.00
TOPUP,Current,2024-04-18 16:50:55,2024-04-18 16:51:00,Top-Up by *7097,826.00,0.00,SEK,COMPLETED,826.00
EXCHANGE,Current,2024-04-18 17:40:43,2024-04-18 17:40:43,Exchange to EUR,-783.34,0.00,SEK,COMPLETED,42.66
CARD_PAYMENT,Current,2024-04-18 16:51:54,2024-04-19 16:06:15,El Corte Inglés,-42.66,0.00,SEK,COMPLETED,0.00
TOPUP,Current,2024-04-20 23:12:55,2024-04-20 23:12:59,Top-Up by *7097,300.00,0.00,SEK,COMPLETED,300.00
EXCHANGE,Current,2024-04-20 23:13:18,2024-04-20 23:13:18,Exchange to EUR,-300.00,0.00,SEK,COMPLETED,0.00
TOPUP,Current,2024-04-22 14:16:11,2024-04-22 14:16:17,Top-Up by *7097,900.00,0.00,SEK,COMPLETED,900.00
TOPUP,Current,2024-04-22 14:16:25,2024-04-22 14:16:30,Top-Up by *7097,900.00,0.00,SEK,COMPLETED,1800.00
EXCHANGE,Current,2024-04-22 14:16:43,2024-04-22 14:16:43,Exchange to EUR,-1800.00,0.00,SEK,COMPLETED,0.00
TOPUP,Current,2024-04-22 14:44:15,2024-04-22 14:44:22,Top-Up by *7097,200.00,0.00,SEK,COMPLETED,200.00
EXCHANGE,Current,2024-04-22 14:44:33,2024-04-22 14:44:33,Exchange to EUR,-200.00,0.00,SEK,COMPLETED,0.00
TOPUP,Current,2024-04-25 13:04:00,2024-04-25 13:04:03,Top-Up by *7097,218.00,0.00,SEK,COMPLETED,218.00
EXCHANGE,Current,2024-04-25 13:04:20,2024-04-25 13:04:20,Exchange to EUR,-218.00,0.00,SEK,COMPLETED,0.00
TOPUP,Current,2024-04-25 17:36:38,2024-04-25 17:36:43,Top-Up by *7097,500.00,0.00,SEK,COMPLETED,500.00
EXCHANGE,Current,2024-04-25 17:36:55,2024-04-25 17:36:55,Exchange to SEK,500.00,0.00,SEK,COMPLETED,1000.00
EXCHANGE,Current,2024-04-25 17:37:14,2024-04-25 17:37:14,Exchange to SEK,131.35,0.00,SEK,COMPLETED,1131.35
EXCHANGE,Current,2024-04-25 17:37:25,2024-04-25 17:37:25,Exchange to EUR,-1131.35,0.00,SEK,COMPLETED,0.00
CARD_REFUND,Current,2024-04-26 02:00:00,2024-04-26 15:34:55,GoDaddy,229.85,0.00,SEK,COMPLETED,229.85
EXCHANGE,Current,2024-04-26 18:00:03,2024-04-26 18:00:03,Exchange to EUR,-229.85,0.00,SEK,COMPLETED,0.00
TOPUP,Current,2024-04-27 13:17:21,2024-04-27 13:17:28,Top-Up by *7097,1000.00,0.00,SEK,COMPLETED,1000.00
EXCHANGE,Current,2024-04-27 13:17:36,2024-04-27 13:17:36,Exchange to EUR,-1000.00,0.00,SEK,COMPLETED,0.00
EXCHANGE,Current,2024-04-29 10:52:14,2024-04-29 10:52:14,Exchange to SEK,2500.00,0.00,SEK,COMPLETED,2500.00
TRANSFER,Current,2024-04-29 10:52:28,2024-04-29 10:52:28,"Revolut Bank UAB, Sucursal en España",-2500.00,0.00,SEK,COMPLETED,0.00
EXCHANGE,Current,2024-04-29 10:53:24,2024-04-29 10:53:24,Exchange to SEK,1000.00,0.00,SEK,COMPLETED,1000.00
EXCHANGE,Current,2024-04-29 19:46:17,2024-04-29 19:46:17,Exchange to EUR,-568.75,0.00,SEK,COMPLETED,431.25
EXCHANGE,Current,2024-04-30 09:14:00,2024-04-30 09:14:00,Exchange to SEK,1000.00,0.00,SEK,COMPLETED,1431.25
TRANSFER,Current,2024-04-30 09:18:57,2024-04-30 15:11:37,International Transfer,-1000.00,0.00,SEK,COMPLETED,431.25
CARD_PAYMENT,Current,2024-04-29 11:39:11,2024-04-30 15:23:52,Adobe,-431.25,0.00,SEK,COMPLETED,0.00
CARD_REFUND,Current,2024-04-29 15:59:29,2024-04-30 15:24:33,Adobe,431.25,0.00,SEK,COMPLETED,431.25
EXCHANGE,Current,2024-04-30 15:34:40,2024-04-30 15:34:40,Exchange to EUR,-431.25,0.00,SEK,COMPLETED,0.00
TOPUP,Current,2024-05-03 13:19:00,2024-05-03 13:19:05,Top-Up by *7097,850.00,0.00,SEK,COMPLETED,850.00
EXCHANGE,Current,2024-05-03 13:19:13,2024-05-03 13:19:13,Exchange to EUR,-850.00,0.00,SEK,COMPLETED,0.00
TRANSFER,Current,2024-05-04 00:39:27,2024-05-04 00:39:27,Transfer from Revolut user,815.00,0.00,SEK,COMPLETED,815.00
EXCHANGE,Current,2024-05-04 01:39:22,2024-05-04 01:39:22,Exchange to EUR,-815.00,0.00,SEK,COMPLETED,0.00
TOPUP,Current,2024-05-10 19:38:54,2024-05-10 19:39:24,Top-Up by *7097,1580.00,0.00,SEK,COMPLETED,1580.00
EXCHANGE,Current,2024-05-10 21:23:06,2024-05-10 21:23:06,Exchange to EUR,-720.14,0.00,SEK,COMPLETED,859.86
ATM,Current,2024-05-10 19:41:07,2024-05-11 11:42:24,Cash at 100610126,-859.86,0.00,SEK,COMPLETED,0.00
TOPUP,Current,2024-05-11 14:11:05,2024-05-11 14:11:10,Top-Up by *7097,200.00,0.00,SEK,COMPLETED,200.00
EXCHANGE,Current,2024-05-11 14:11:22,2024-05-11 14:11:22,Exchange to EUR,-200.00,0.00,SEK,COMPLETED,0.00
TRANSFER,Current,2024-05-11 18:29:45,2024-05-11 18:29:45,Transfer from Revolut user,5000.00,0.00,SEK,COMPLETED,5000.00
CARD_PAYMENT,Current,2024-05-11 22:13:29,2024-05-12 10:31:15,Glovo,-246.96,2.47,SEK,COMPLETED,4750.57
CARD_PAYMENT,Current,2024-05-11 20:00:22,2024-05-12 11:07:30,Sky Bar Hotel Almudaina,-122.95,1.23,SEK,COMPLETED,4626.39
CARD_PAYMENT,Current,2024-05-11 18:32:51,2024-05-12 11:07:30,Sky Bar Hotel Almudaina,-228.34,2.28,SEK,COMPLETED,4395.77
CARD_PAYMENT,Current,2024-05-11 18:35:22,2024-05-12 11:07:35,Sky Bar Hotel Almudaina,-222.48,2.22,SEK,COMPLETED,4171.07
EXCHANGE,Current,2024-05-12 12:19:07,2024-05-12 12:19:07,Exchange to EUR,-4055.76,0.00,SEK,COMPLETED,115.31
CARD_PAYMENT,Current,2024-05-11 21:57:46,2024-05-12 13:18:24,Bendita,-114.17,1.14,SEK,COMPLETED,0.00
TRANSFER,Current,2024-05-17 11:24:23,2024-05-17 11:24:23,"Revolut Bank UAB, Sucursal en España",915.00,0.00,SEK,COMPLETED,915.00
CARD_PAYMENT,Current,2024-05-17 11:27:29,2024-05-19 15:15:26,Go Daddy,-910.60,0.00,SEK,COMPLETED,4.40
CARD_PAYMENT,Current,2024-05-19 02:00:00,2024-05-21 10:35:03,Transport de les Illes Balears,-31.41,0.00,SEK,COMPLETED,-27.01
EXCHANGE,Current,2024-05-21 10:44:35,2024-05-21 10:44:35,Exchange to SEK,4.28,0.00,SEK,COMPLETED,-22.73
EXCHANGE,Current,2024-05-21 10:44:35,2024-05-21 10:44:35,Exchange to SEK,0.10,0.00,SEK,COMPLETED,-22.63
TOPUP,Current,2024-05-21 21:50:36,2024-05-21 21:51:00,Top-Up by *7097,1000.00,0.00,SEK,COMPLETED,977.37
EXCHANGE,Current,2024-05-21 21:51:17,2024-05-21 21:51:17,Exchange to EUR,-977.37,0.00,SEK,COMPLETED,0.00
TOPUP,Current,2024-05-22 12:51:11,2024-05-22 12:51:17,Top-Up by *7097,1000.00,0.00,SEK,COMPLETED,1000.00
EXCHANGE,Current,2024-05-22 12:51:32,2024-05-22 12:51:32,Exchange to EUR,-1000.00,0.00,SEK,COMPLETED,0.00
TOPUP,Current,2024-05-27 12:58:12,2024-05-27 12:58:16,Top-Up by *7097,317.00,0.00,SEK,COMPLETED,317.00
EXCHANGE,Current,2024-05-27 12:58:28,2024-05-27 12:58:28,Exchange to EUR,-317.00,0.00,SEK,COMPLETED,0.00
TOPUP,Current,2024-05-28 23:28:51,2024-05-28 23:28:55,Top-Up by *7097,200.00,0.00,SEK,COMPLETED,200.00
EXCHANGE,Current,2024-05-28 23:29:17,2024-05-28 23:29:17,Exchange to EUR,-200.00,0.00,SEK,COMPLETED,0.00
TOPUP,Current,2024-05-29 12:20:32,2024-05-29 12:20:53,Top-Up by *7097,758.00,0.00,SEK,COMPLETED,758.00
EXCHANGE,Current,2024-05-29 12:21:05,2024-05-29 12:21:05,Exchange to EUR,-758.00,0.00,SEK,COMPLETED,0.00
TRANSFER,Current,2024-05-29 16:04:41,2024-05-29 16:04:41,"Revolut Bank UAB, Sucursal en España",10.00,0.00,SEK,COMPLETED,10.00
EXCHANGE,Current,2024-05-29 16:05:13,2024-05-29 16:05:13,Exchange to SEK,10.00,0.00,SEK,COMPLETED,20.00
EXCHANGE,Current,2024-05-29 19:59:36,2024-05-29 19:59:36,Exchange to EUR,-20.00,0.00,SEK,COMPLETED,0.00
EXCHANGE,Current,2024-05-30 09:07:20,2024-05-30 09:07:20,Exchange to SEK,1000.00,0.00,SEK,COMPLETED,1000.00
TRANSFER,Current,2024-05-30 09:08:06,2024-05-30 09:08:06,Transfer to Revolut user,-1000.00,0.00,SEK,COMPLETED,0.00
EXCHANGE,Current,2024-05-31 17:47:15,2024-05-31 17:47:15,Exchange to SEK,1.00,0.00,SEK,COMPLETED,1.00
TOPUP,Current,2024-06-06 10:28:46,2024-06-06 10:28:52,Top-Up by *7097,554.00,0.00,SEK,COMPLETED,555.00
EXCHANGE,Current,2024-06-06 10:28:58,2024-06-06 10:28:58,Exchange to EUR,-555.00,0.00,SEK,COMPLETED,0.00
TOPUP,Current,2024-06-07 12:52:38,2024-06-07 12:52:41,Top-Up by *7097,600.00,0.00,SEK,COMPLETED,600.00
EXCHANGE,Current,2024-06-07 12:53:00,2024-06-07 12:53:00,Exchange to EUR,-600.00,0.00,SEK,COMPLETED,0.00
TOPUP,Current,2024-06-10 20:03:34,2024-06-10 20:03:39,Top-Up by *7097,1000.00,0.00,SEK,COMPLETED,1000.00
TOPUP,Current,2024-06-10 20:03:53,2024-06-10 20:03:57,Top-Up by *7097,514.00,0.00,SEK,COMPLETED,1514.00
EXCHANGE,Current,2024-06-10 20:04:27,2024-06-10 20:04:27,Exchange to EUR,-1514.00,0.00,SEK,COMPLETED,0.00
TOPUP,Current,2024-06-12 14:43:48,2024-06-12 14:43:51,Top-Up by *7097,120.00,0.00,SEK,COMPLETED,120.00
TOPUP,Current,2024-06-12 17:40:42,2024-06-12 17:40:45,Top-Up by *7097,1000.00,0.00,SEK,COMPLETED,1120.00
TOPUP,Current,2024-06-12 17:40:54,2024-06-12 17:40:57,Top-Up by *7097,221.00,0.00,SEK,COMPLETED,1341.00
EXCHANGE,Current,2024-06-12 17:41:18,2024-06-12 17:41:18,Exchange to EUR,-504.37,0.00,SEK,COMPLETED,836.63
CARD_PAYMENT,Current,2024-06-12 19:05:53,2024-06-13 12:38:23,Glovo,-149.08,0.00,SEK,COMPLETED,687.55
EXCHANGE,Current,2024-06-13 12:51:55,2024-06-13 12:51:55,Exchange to EUR,-658.95,0.00,SEK,COMPLETED,28.60
CARD_PAYMENT,Current,2024-06-12 14:43:58,2024-06-13 13:12:50,Sapporet Bar,-28.60,0.00,SEK,COMPLETED,0.00
TOPUP,Current,2024-06-14 15:01:02,2024-06-14 15:01:05,Top-Up by *7097,174.00,0.00,SEK,COMPLETED,174.00
EXCHANGE,Current,2024-06-14 15:01:22,2024-06-14 15:01:22,Exchange to EUR,-174.00,0.00,SEK,COMPLETED,0.00
TOPUP,Current,2024-06-18 20:51:06,2024-06-18 20:51:09,Top-Up by *7097,215.00,0.00,SEK,COMPLETED,215.00
EXCHANGE,Current,2024-06-18 20:51:19,2024-06-18 20:51:19,Exchange to EUR,-215.00,0.00,SEK,COMPLETED,0.00
TOPUP,Current,2024-06-20 22:43:52,2024-06-20 22:43:55,Top-Up by *7097,215.00,0.00,SEK,COMPLETED,215.00
TOPUP,Current,2024-06-20 23:16:11,2024-06-20 23:16:15,Top-Up by *7097,1000.00,0.00,SEK,COMPLETED,1215.00
TOPUP,Current,2024-06-20 23:19:29,2024-06-20 23:19:32,Top-Up by *7097,696.00,0.00,SEK,COMPLETED,1911.00
EXCHANGE,Current,2024-06-20 23:20:32,2024-06-20 23:20:32,Exchange to EUR,-1072.19,0.00,SEK,COMPLETED,838.81
ATM,Current,2024-06-20 23:16:53,2024-06-21 11:32:16,Cash at Cashzone,-822.36,16.45,SEK,COMPLETED,0.00
TOPUP,Current,2024-06-21 19:22:14,2024-06-21 19:22:18,Top-Up by *7097,1000.00,0.00,SEK,COMPLETED,1000.00
EXCHANGE,Current,2024-06-21 19:23:19,2024-06-21 19:23:19,Exchange to EUR,-1000.00,0.00,SEK,COMPLETED,0.00
TOPUP,Current,2024-06-22 01:33:02,2024-06-22 01:33:06,Top-Up by *7097,1000.00,0.00,SEK,COMPLETED,1000.00
TOPUP,Current,2024-06-22 01:33:32,2024-06-22 01:33:36,Top-Up by *7097,414.00,0.00,SEK,COMPLETED,1414.00
EXCHANGE,Current,2024-06-22 01:34:01,2024-06-22 01:34:01,Exchange to EUR,-1414.00,0.00,SEK,COMPLETED,0.00
TOPUP,Current,2024-06-22 01:41:45,2024-06-22 01:41:48,Top-Up by *7097,1000.00,0.00,SEK,COMPLETED,1000.00
EXCHANGE,Current,2024-06-22 01:41:57,2024-06-22 01:41:57,Exchange to EUR,-1000.00,0.00,SEK,COMPLETED,0.00
TOPUP,Current,2024-06-22 14:10:46,2024-06-22 14:11:30,Top-Up by *7097,500.00,0.00,SEK,COMPLETED,500.00
EXCHANGE,Current,2024-06-22 14:11:47,2024-06-22 14:11:47,Exchange to EUR,-500.00,0.00,SEK,COMPLETED,0.00
TOPUP,Current,2024-06-23 00:45:45,2024-06-23 00:46:10,Top-Up by *7097,1500.00,0.00,SEK,COMPLETED,1500.00
EXCHANGE,Current,2024-06-23 02:09:13,2024-06-23 02:09:13,Exchange to EUR,-566.21,0.00,SEK,COMPLETED,933.79
CARD_PAYMENT,Current,2024-06-23 01:42:44,2024-06-23 10:15:12,Luna Palma,-180.40,1.80,SEK,COMPLETED,751.59
CARD_PAYMENT,Current,2024-06-23 01:28:45,2024-06-23 10:15:12,Luna Palma,-225.50,2.26,SEK,COMPLETED,523.83
CARD_PAYMENT,Current,2024-06-23 00:51:06,2024-06-23 10:15:14,Luna Palma,-518.64,5.19,SEK,COMPLETED,0.00
TOPUP,Current,2024-06-24 20:40:06,2024-06-24 20:40:51,Top-Up by *7097,1000.00,0.00,SEK,COMPLETED,1000.00
EXCHANGE,Current,2024-06-24 20:41:25,2024-06-24 20:41:25,Exchange to EUR,-1000.00,0.00,SEK,COMPLETED,0.00
TOPUP,Current,2024-06-24 22:05:14,2024-06-24 22:05:40,Top-Up by *7097,1000.00,0.00,SEK,COMPLETED,1000.00
EXCHANGE,Current,2024-06-24 22:06:11,2024-06-24 22:06:11,Exchange to EUR,-1000.00,0.00,SEK,COMPLETED,0.00
TOPUP,Current,2024-06-24 23:49:36,2024-06-24 23:49:56,Top-Up by *7097,1000.00,0.00,SEK,COMPLETED,1000.00
TOPUP,Current,2024-06-24 23:50:03,2024-06-24 23:50:17,Top-Up by *7097,1000.00,0.00,SEK,COMPLETED,2000.00
EXCHANGE,Current,2024-06-24 23:50:26,2024-06-24 23:50:26,Exchange to EUR,-2000.00,0.00,SEK,COMPLETED,0.00
TOPUP,Current,2024-06-28 17:04:05,2024-06-28 17:04:09,Top-Up by *7097,120.00,0.00,SEK,COMPLETED,120.00
TOPUP,Current,2024-06-28 17:26:47,2024-06-28 17:26:50,Top-Up by *7097,150.00,0.00,SEK,COMPLETED,270.00
EXCHANGE,Current,2024-06-28 17:27:00,2024-06-28 17:27:00,Exchange to EUR,-202.82,0.00,SEK,COMPLETED,67.18
TOPUP,Current,2024-06-29 09:44:14,2024-06-29 09:44:17,Top-Up by *7097,800.00,0.00,SEK,COMPLETED,867.18
EXCHANGE,Current,2024-06-29 09:44:50,2024-06-29 09:44:50,Exchange to EUR,-800.00,0.00,SEK,COMPLETED,67.18
EXCHANGE,Current,2024-06-29 18:15:58,2024-06-29 18:15:58,Exchange to SEK,471.58,4.72,SEK,COMPLETED,534.04
CARD_PAYMENT,Current,2024-06-28 17:04:29,2024-06-29 20:17:07,Tabacos,-67.18,0.00,SEK,COMPLETED,466.86
TOPUP,Current,2024-06-30 11:46:28,2024-06-30 11:46:31,Top-Up by *7097,500.00,0.00,SEK,COMPLETED,966.86
EXCHANGE,Current,2024-06-30 11:46:51,2024-06-30 11:46:51,Exchange to EUR,-500.86,0.00,SEK,COMPLETED,466.00
CARD_PAYMENT,Current,2024-06-29 18:16:21,2024-06-30 16:16:15,bet365,-466.00,0.00,SEK,COMPLETED,0.00
EXCHANGE,Current,2024-06-30 18:33:56,2024-06-30 18:33:56,Exchange to SEK,113.37,1.13,SEK,COMPLETED,112.24
TOPUP,Current,2024-06-30 20:46:14,2024-06-30 20:47:01,Top-Up by *7097,1500.00,0.00,SEK,COMPLETED,1612.24
TOPUP,Current,2024-06-30 23:14:44,2024-06-30 23:14:47,Top-Up by *7097,1000.00,0.00,SEK,COMPLETED,2612.24
EXCHANGE,Current,2024-06-30 23:14:55,2024-06-30 23:14:55,Exchange to EUR,-1708.25,0.00,SEK,COMPLETED,903.99
TOPUP,Current,2024-07-01 01:39:30,2024-07-01 01:39:33,Top-Up by *7097,1000.00,0.00,SEK,COMPLETED,1903.99
EXCHANGE,Current,2024-07-01 01:39:44,2024-07-01 01:39:44,Exchange to EUR,-1000.00,0.00,SEK,COMPLETED,903.99
EXCHANGE,Current,2024-07-01 03:44:12,2024-07-01 03:44:12,Exchange to SEK,3000.00,0.00,SEK,COMPLETED,3903.99
TRANSFER,Current,2024-07-01 03:44:57,2024-07-01 03:44:58,Transfer to Revolut user,-3000.00,0.00,SEK,COMPLETED,903.99
CARD_PAYMENT,Current,2024-06-30 22:40:02,2024-07-01 14:09:53,Mm S.l.,-91.08,0.91,SEK,COMPLETED,812.00
CARD_PAYMENT,Current,2024-06-30 18:34:24,2024-07-01 18:18:58,bet365,-112.00,0.00,SEK,COMPLETED,700.00
CARD_PAYMENT,Current,2024-06-30 21:02:32,2024-07-01 19:15:32,bet365,-500.00,0.00,SEK,COMPLETED,200.00
CARD_PAYMENT,Current,2024-06-30 21:18:47,2024-07-01 19:15:49,bet365,-200.00,0.00,SEK,COMPLETED,0.00
TOPUP,Current,2024-07-05 14:45:54,2024-07-05 14:45:58,Top-Up by *7097,214.00,0.00,SEK,COMPLETED,214.00
EXCHANGE,Current,2024-07-05 14:46:10,2024-07-05 14:46:10,Exchange to EUR,-214.00,0.00,SEK,COMPLETED,0.00
TOPUP,Current,2024-07-06 22:15:34,2024-07-06 22:15:37,Top-Up by *7097,1000.00,0.00,SEK,COMPLETED,1000.00
EXCHANGE,Current,2024-07-06 22:15:46,2024-07-06 22:15:46,Exchange to EUR,-1000.00,0.00,SEK,COMPLETED,0.00
TOPUP,Current,2024-07-11 17:17:46,2024-07-11 17:17:50,Top-Up by *7097,1000.00,0.00,SEK,COMPLETED,1000.00
TOPUP,Current,2024-07-11 17:17:57,2024-07-11 17:18:01,Top-Up by *7097,1000.00,0.00,SEK,COMPLETED,2000.00
EXCHANGE,Current,2024-07-11 17:18:09,2024-07-11 17:18:09,Exchange to EUR,-2000.00,0.00,SEK,COMPLETED,0.00
TOPUP,Current,2024-07-11 17:18:17,2024-07-11 17:18:20,Top-Up by *7097,1000.00,0.00,SEK,COMPLETED,1000.00
EXCHANGE,Current,2024-07-11 17:18:39,2024-07-11 17:18:39,Exchange to EUR,-1000.00,0.00,SEK,COMPLETED,0.00
TOPUP,Current,2024-07-11 17:19:00,2024-07-11 17:19:16,Top-Up by *7097,1000.00,0.00,SEK,COMPLETED,1000.00
EXCHANGE,Current,2024-07-11 17:19:23,2024-07-11 17:19:23,Exchange to EUR,-1000.00,0.00,SEK,COMPLETED,0.00
TOPUP,Current,2024-07-11 17:32:16,2024-07-11 17:32:42,Top-Up by *7097,548.00,0.00,SEK,COMPLETED,548.00
EXCHANGE,Current,2024-07-11 17:33:07,2024-07-11 17:33:07,Exchange to EUR,-548.00,0.00,SEK,COMPLETED,0.00
TOPUP,Current,2024-07-12 19:03:37,2024-07-12 19:03:42,Top-Up by *7097,1000.00,0.00,SEK,COMPLETED,1000.00
TOPUP,Current,2024-07-12 19:03:55,2024-07-12 19:03:59,Top-Up by *7097,700.00,0.00,SEK,COMPLETED,1700.00
EXCHANGE,Current,2024-07-12 19:04:14,2024-07-12 19:04:14,Exchange to EUR,-1700.00,0.00,SEK,COMPLETED,0.00
TOPUP,Current,2024-07-14 02:48:24,2024-07-14 02:48:27,Top-Up by *7097,1000.00,0.00,SEK,COMPLETED,1000.00
TOPUP,Current,2024-07-14 02:49:53,2024-07-14 02:50:17,Top-Up by *7097,600.00,0.00,SEK,COMPLETED,1600.00
EXCHANGE,Current,2024-07-14 02:50:28,2024-07-14 02:50:28,Exchange to EUR,-1600.00,0.00,SEK,COMPLETED,0.00
TOPUP,Current,2024-07-19 12:32:24,2024-07-19 12:32:27,Top-Up by *7097,141.00,0.00,SEK,COMPLETED,141.00
EXCHANGE,Current,2024-07-19 12:32:34,2024-07-19 12:32:34,Exchange to EUR,-141.00,0.00,SEK,COMPLETED,0.00
TOPUP,Current,2024-07-23 01:46:16,2024-07-23 01:46:22,Top-Up by *7097,1000.00,0.00,SEK,COMPLETED,1000.00
TOPUP,Current,2024-07-23 01:47:44,2024-07-23 01:47:47,Top-Up by *7097,1000.00,0.00,SEK,COMPLETED,2000.00
TOPUP,Current,2024-07-23 01:47:53,2024-07-23 01:47:56,Top-Up by *7097,1000.00,0.00,SEK,COMPLETED,3000.00
TOPUP,Current,2024-07-23 01:48:04,2024-07-23 01:48:21,Top-Up by *7097,700.00,0.00,SEK,COMPLETED,3700.00
EXCHANGE,Current,2024-07-23 02:53:40,2024-07-23 02:53:40,Exchange to EUR,-2661.35,0.00,SEK,COMPLETED,1038.65
ATM,Current,2024-07-23 01:55:53,2024-07-23 14:23:28,Cash at 121000791,-854.96,0.00,SEK,COMPLETED,183.69
CARD_PAYMENT,Current,2024-07-23 02:30:53,2024-07-24 10:33:07,Uber,-91.44,0.00,SEK,COMPLETED,92.25
CARD_PAYMENT,Current,2024-07-23 02:24:57,2024-07-24 12:16:39,Uber,-93.78,0.00,SEK,COMPLETED,-1.53
EXCHANGE,Current,2024-07-24 12:59:49,2024-07-24 12:59:49,Exchange to SEK,1.63,0.00,SEK,COMPLETED,0.10
TOPUP,Current,2024-07-25 21:19:26,2024-07-25 21:19:46,Top-Up by *7097,1625.00,0.00,SEK,COMPLETED,1625.10
EXCHANGE,Current,2024-07-25 21:19:57,2024-07-25 21:19:57,Exchange to EUR,-1625.10,0.00,SEK,COMPLETED,0.00
TOPUP,Current,2024-07-26 15:39:52,2024-07-26 15:40:13,Top-Up by *7097,1400.00,0.00,SEK,COMPLETED,1400.00
EXCHANGE,Current,2024-07-26 15:40:22,2024-07-26 15:40:22,Exchange to EUR,-1400.00,0.00,SEK,COMPLETED,0.00
TOPUP,Current,2024-07-27 00:15:21,2024-07-27 00:15:23,Top-Up by *7097,1000.00,0.00,SEK,COMPLETED,1000.00
EXCHANGE,Current,2024-07-27 00:24:18,2024-07-27 00:24:18,Exchange to EUR,-1000.00,0.00,SEK,COMPLETED,0.00
TOPUP,Current,2024-08-01 08:05:41,2024-08-01 08:06:00,Top-Up by *7097,2000.00,0.00,SEK,COMPLETED,2000.00
TOPUP,Current,2024-08-01 08:06:07,2024-08-01 08:06:23,Top-Up by *7097,2000.00,0.00,SEK,COMPLETED,4000.00
TOPUP,Current,2024-08-01 08:06:48,2024-08-01 08:07:06,Top-Up by *7097,1500.00,0.00,SEK,COMPLETED,5500.00
EXCHANGE,Current,2024-08-01 08:07:15,2024-08-01 08:07:15,Exchange to EUR,-5500.00,0.00,SEK,COMPLETED,0.00
TOPUP,Current,2024-08-01 08:27:34,2024-08-01 08:27:56,Top-Up by *7097,169.99,0.00,SEK,COMPLETED,169.99
FEE,Current,2024-08-01 08:28:00,2024-08-01 08:28:00,Metal plan fee,-169.99,0.00,SEK,COMPLETED,0.00
EXCHANGE,Current,2024-08-01 08:31:45,2024-08-01 08:31:45,Exchange to SEK,5253.90,0.00,SEK,COMPLETED,5253.90
EXCHANGE,Current,2024-08-01 08:58:48,2024-08-01 08:58:48,Exchange to EUR,-5253.90,0.00,SEK,COMPLETED,0.00
TOPUP,Current,2024-08-04 13:16:11,2024-08-04 13:16:13,Apple Pay Top-Up by *0722,475.00,0.00,SEK,COMPLETED,475.00
EXCHANGE,Current,2024-08-04 13:16:29,2024-08-04 13:16:29,Exchange to EUR,-475.00,0.00,SEK,COMPLETED,0.00
TOPUP,Current,2024-08-07 13:06:01,2024-08-07 13:06:03,Apple Pay Top-Up by *0722,371.00,0.00,SEK,COMPLETED,371.00
EXCHANGE,Current,2024-08-07 13:06:14,2024-08-07 13:06:14,Exchange to EUR,-371.00,0.00,SEK,COMPLETED,0.00
TOPUP,Current,2024-08-09 22:23:52,2024-08-09 22:23:53,Apple Pay Top-Up by *0722,1621.00,0.00,SEK,COMPLETED,1621.00
EXCHANGE,Current,2024-08-09 22:24:04,2024-08-09 22:24:04,Exchange to EUR,-1621.00,0.00,SEK,COMPLETED,0.00
TOPUP,Current,2024-08-10 03:05:06,2024-08-10 03:05:24,Top-Up by *7097,1000.00,0.00,SEK,COMPLETED,1000.00
TOPUP,Current,2024-08-10 03:05:49,2024-08-10 03:05:50,Apple Pay Top-Up by *0722,1000.00,0.00,SEK,COMPLETED,2000.00
TOPUP,Current,2024-08-10 03:06:16,2024-08-10 03:06:18,Apple Pay Top-Up by *0722,1000.00,0.00,SEK,COMPLETED,3000.00
TOPUP,Current,2024-08-10 03:06:32,2024-08-10 03:06:34,Apple Pay Top-Up by *0722,1000.00,0.00,SEK,COMPLETED,4000.00
TOPUP,Current,2024-08-10 03:06:51,2024-08-10 03:06:52,Apple Pay Top-Up by *0722,1000.00,0.00,SEK,COMPLETED,5000.00
EXCHANGE,Current,2024-08-10 03:07:04,2024-08-10 03:07:04,Exchange to EUR,-5000.00,0.00,SEK,COMPLETED,0.00
TOPUP,Current,2024-08-10 03:10:00,2024-08-10 03:10:02,Apple Pay Top-Up by *0722,1000.00,0.00,SEK,COMPLETED,1000.00
EXCHANGE,Current,2024-08-10 03:10:10,2024-08-10 03:10:10,Exchange to EUR,-1000.00,0.00,SEK,COMPLETED,0.00
TOPUP,Current,2024-08-13 22:28:00,2024-08-13 22:28:02,Apple Pay Top-Up by *0722,811.00,0.00,SEK,COMPLETED,811.00
EXCHANGE,Current,2024-08-13 22:28:14,2024-08-13 22:28:14,Exchange to EUR,-811.00,0.00,SEK,COMPLETED,0.00
TOPUP,Current,2024-08-14 01:12:44,2024-08-14 01:12:46,Apple Pay Top-Up by *0722,1500.00,0.00,SEK,COMPLETED,1500.00
EXCHANGE,Current,2024-08-14 01:12:57,2024-08-14 01:12:57,Exchange to EUR,-1500.00,0.00,SEK,COMPLETED,0.00
TOPUP,Current,2024-08-14 03:48:39,2024-08-14 03:48:41,Apple Pay Top-Up by *0722,1897.00,0.00,SEK,COMPLETED,1897.00
EXCHANGE,Current,2024-08-14 03:48:52,2024-08-14 03:48:52,Exchange to EUR,-1897.00,0.00,SEK,COMPLETED,0.00
TOPUP,Current,2024-08-14 05:07:35,2024-08-14 05:07:36,Apple Pay Top-Up by *0722,230.00,0.00,SEK,COMPLETED,230.00
EXCHANGE,Current,2024-08-14 05:07:49,2024-08-14 05:07:49,Exchange to EUR,-230.00,0.00,SEK,COMPLETED,0.00
TOPUP,Current,2024-08-16 21:45:58,2024-08-16 21:46:00,Apple Pay Top-Up by *0722,798.00,0.00,SEK,COMPLETED,798.00
EXCHANGE,Current,2024-08-16 21:46:09,2024-08-16 21:46:09,Exchange to EUR,-798.00,0.00,SEK,COMPLETED,0.00
TOPUP,Current,2024-08-16 21:47:51,2024-08-16 21:47:52,Apple Pay Top-Up by *0722,120.00,0.00,SEK,COMPLETED,120.00
EXCHANGE,Current,2024-08-16 21:48:01,2024-08-16 21:48:01,Exchange to EUR,-120.00,0.00,SEK,COMPLETED,0.00
TOPUP,Current,2024-08-17 03:19:52,2024-08-17 03:19:54,Apple Pay Top-Up by *0722,2000.00,0.00,SEK,COMPLETED,2000.00
TOPUP,Current,2024-08-17 03:20:30,2024-08-17 03:20:31,Apple Pay Top-Up by *0722,1250.00,0.00,SEK,COMPLETED,3250.00
EXCHANGE,Current,2024-08-17 03:20:54,2024-08-17 03:20:54,Exchange to EUR,-3250.00,0.00,SEK,COMPLETED,0.00
TOPUP,Current,2024-08-23 03:27:05,2024-08-23 03:27:07,Apple Pay Top-Up by *0722,2000.00,0.00,SEK,COMPLETED,2000.00
TOPUP,Current,2024-08-23 03:27:25,2024-08-23 03:27:27,Apple Pay Top-Up by *0722,1000.00,0.00,SEK,COMPLETED,3000.00
EXCHANGE,Current,2024-08-23 03:27:37,2024-08-23 03:27:37,Exchange to EUR,-3000.00,0.00,SEK,COMPLETED,0.00
EXCHANGE,Current,2024-08-23 09:23:11,2024-08-23 09:23:11,Exchange to SEK,6010.80,0.00,SEK,COMPLETED,6010.80
TRANSFER,Current,2024-08-23 12:23:33,2024-08-23 12:23:33,Transfer to Revolut user,-6010.00,0.00,SEK,COMPLETED,0.80
TOPUP,Current,2024-08-25 03:37:27,2024-08-25 03:37:29,Apple Pay Top-Up by *0722,300.00,0.00,SEK,COMPLETED,300.80
EXCHANGE,Current,2024-08-25 03:37:45,2024-08-25 03:37:45,Exchange to EUR,-300.80,0.00,SEK,COMPLETED,0.00
TOPUP,Current,2024-08-25 04:29:53,2024-08-25 04:29:54,Apple Pay Top-Up by *0722,2000.00,0.00,SEK,COMPLETED,2000.00
TOPUP,Current,2024-08-25 04:30:17,2024-08-25 04:30:18,Apple Pay Top-Up by *0722,1000.00,0.00,SEK,COMPLETED,3000.00
EXCHANGE,Current,2024-08-25 04:30:33,2024-08-25 04:30:33,Exchange to EUR,-3000.00,0.00,SEK,COMPLETED,0.00
TOPUP,Current,2024-08-25 04:31:56,2024-08-25 04:31:58,Apple Pay Top-Up by *0722,2000.00,0.00,SEK,COMPLETED,2000.00
TOPUP,Current,2024-08-25 04:32:22,2024-08-25 04:32:23,Apple Pay Top-Up by *0722,1000.00,0.00,SEK,COMPLETED,3000.00
EXCHANGE,Current,2024-08-25 04:32:36,2024-08-25 04:32:36,Exchange to EUR,-3000.00,0.00,SEK,COMPLETED,0.00
TOPUP,Current,2024-08-25 05:07:11,2024-08-25 05:07:14,Apple Pay Top-Up by *0722,150.00,0.00,SEK,COMPLETED,150.00
EXCHANGE,Current,2024-08-25 05:07:25,2024-08-25 05:07:25,Exchange to EUR,-150.00,0.00,SEK,COMPLETED,0.00
TOPUP,Current,2024-08-28 14:28:45,2024-08-28 14:28:47,Apple Pay Top-Up by *0722,1021.00,0.00,SEK,COMPLETED,1021.00
EXCHANGE,Current,2024-08-28 14:30:22,2024-08-28 14:30:22,Exchange to EUR,-1021.00,0.00,SEK,COMPLETED,0.00
TOPUP,Current,2024-08-28 18:10:50,2024-08-28 18:10:52,Apple Pay Top-Up by *0722,420.00,0.00,SEK,COMPLETED,420.00
EXCHANGE,Current,2024-08-29 04:23:29,2024-08-29 04:23:29,Exchange to EUR,-420.00,0.00,SEK,COMPLETED,0.00
TOPUP,Current,2024-08-30 01:11:39,2024-08-30 01:11:41,Apple Pay Top-Up by *0722,1500.00,0.00,SEK,COMPLETED,1500.00
TOPUP,Current,2024-08-30 01:14:15,2024-08-30 01:14:18,Apple Pay Top-Up by *0722,500.00,0.00,SEK,COMPLETED,2000.00
EXCHANGE,Current,2024-08-30 01:14:56,2024-08-30 01:14:56,Exchange to EUR,-2000.00,0.00,SEK,COMPLETED,0.00
FEE,Current,2024-09-01 02:25:59,2024-09-01 02:25:59,Metal plan fee,-169.99,0.00,SEK,COMPLETED,-169.99
EXCHANGE,Current,2024-09-01 02:31:00,2024-09-01 02:31:00,Exchange to SEK,0.90,0.00,SEK,COMPLETED,-169.09
TOPUP,Current,2024-09-09 11:38:50,2024-09-09 11:38:53,Auto Top-Up by *7097,169.09,0.00,SEK,COMPLETED,0.00
TOPUP,Current,2024-09-11 10:52:30,2024-09-11 10:52:32,Apple Pay Top-Up by *0722,349.00,0.00,SEK,COMPLETED,349.00
CARD_PAYMENT,Current,2024-09-12 13:16:48,2024-09-13 14:54:37,il Mafioso Pizzeria 🇮🇹 Pasteria,-135.00,0.00,SEK,COMPLETED,214.00
CARD_PAYMENT,Current,2024-09-13 13:30:59,2024-09-14 11:38:21,Pressbyrån,-26.00,0.00,SEK,COMPLETED,188.00
CARD_PAYMENT,Current,2024-09-13 20:59:15,2024-09-14 11:38:38,Alby Bilecen Kiosk Han,-50.00,0.00,SEK,COMPLETED,138.00
CARD_PAYMENT,Current,2024-09-13 17:57:44,2024-09-14 11:38:43,Tingstorget Bageri,-26.00,0.00,SEK,COMPLETED,112.00
EXCHANGE,Current,2024-09-15 13:09:08,2024-09-15 13:09:08,Exchange to EUR,-112.00,0.00,SEK,COMPLETED,0.00
TOPUP,Current,2024-09-17 13:55:45,2024-09-17 13:55:47,Apple Pay Top-Up by *0722,694.00,0.00,SEK,COMPLETED,694.00
EXCHANGE,Current,2024-09-17 16:34:33,2024-09-17 16:34:33,Exchange to EUR,-644.00,0.00,SEK,COMPLETED,50.00
CARD_PAYMENT,Current,2024-09-17 15:41:10,2024-09-18 12:20:06,Pressbyrån,-50.00,0.00,SEK,COMPLETED,0.00
TOPUP,Current,2024-09-19 11:52:59,2024-09-19 11:53:00,Apple Pay Top-Up by *3659,131.00,0.00,SEK,COMPLETED,131.00
EXCHANGE,Current,2024-09-19 11:53:28,2024-09-19 11:53:28,Exchange to SEK,315.35,0.00,SEK,COMPLETED,446.35
CARD_PAYMENT,Current,2024-09-19 11:59:51,2024-09-20 13:04:01,Alby Bilecen Kiosk Han,-50.00,0.00,SEK,COMPLETED,396.35
CARD_PAYMENT,Current,2024-09-19 11:58:38,2024-09-21 13:41:57,il Mafioso Pizzeria 🇮🇹 Pasteria,-130.00,0.00,SEK,COMPLETED,266.35
TOPUP,Current,2024-09-22 08:51:42,2024-09-22 08:51:44,Apple Pay Top-Up by *0722,1000.00,0.00,SEK,COMPLETED,1266.35
TOPUP,Current,2024-09-22 08:52:56,2024-09-22 08:52:58,Apple Pay Top-Up by *0722,734.00,0.00,SEK,COMPLETED,2000.35
CARD_PAYMENT,Current,2024-09-22 02:49:09,2024-09-22 15:08:20,SL,-42.00,0.00,SEK,COMPLETED,1958.35
CARD_PAYMENT,Current,2024-09-22 19:06:41,2024-09-23 11:16:29,WHSmith,-39.00,0.00,SEK,COMPLETED,1919.35
EXCHANGE,Current,2024-09-23 13:28:31,2024-09-23 13:28:31,Exchange to EUR,-997.81,0.00,SEK,COMPLETED,921.54
CARD_PAYMENT,Current,2024-09-22 18:04:07,2024-09-23 14:59:34,Bolt,-397.00,0.00,SEK,COMPLETED,524.54
TOPUP,Current,2024-09-23 19:50:09,2024-09-23 19:50:11,Apple Pay Top-Up by *0722,288.00,0.00,SEK,COMPLETED,812.54
EXCHANGE,Current,2024-09-23 19:50:24,2024-09-23 19:50:24,Exchange to EUR,-288.00,0.00,SEK,COMPLETED,524.54
CARD_PAYMENT,Current,2024-09-23 00:18:32,2024-09-24 10:50:04,Taxi 4132,-279.61,0.00,SEK,COMPLETED,244.93
CARD_PAYMENT,Current,2024-09-23 09:02:40,2024-09-24 10:50:56,El Corte Inglés,-16.86,0.00,SEK,COMPLETED,228.07
CARD_PAYMENT,Current,2024-09-23 12:30:08,2024-09-24 12:32:39,Panineria,-193.86,0.00,SEK,COMPLETED,34.21
CARD_PAYMENT,Current,2024-09-23 12:33:13,2024-09-24 12:33:26,Panineria,-34.21,0.00,SEK,COMPLETED,0.00
TOPUP,Current,2024-09-26 16:22:17,2024-09-26 16:22:19,Apple Pay Top-Up by *3659,144.00,0.00,SEK,COMPLETED,144.00
EXCHANGE,Current,2024-09-26 16:22:28,2024-09-26 16:22:28,Exchange to EUR,-144.00,0.00,SEK,COMPLETED,0.00
TOPUP,Current,2024-09-27 16:22:18,2024-09-27 16:23:02,Top-Up by *7097,1500.00,0.00,SEK,COMPLETED,1500.00
TRANSFER,Current,2024-09-27 16:34:16,2024-09-27 16:34:16,"Revolut Bank UAB, Sucursal en España",-1500.00,0.00,SEK,COMPLETED,0.00
TOPUP,Current,2024-09-29 13:55:40,2024-09-29 13:56:03,Top-Up by *7097,392.00,0.00,SEK,COMPLETED,392.00
EXCHANGE,Current,2024-09-29 13:56:15,2024-09-29 13:56:15,Exchange to EUR,-392.00,0.00,SEK,COMPLETED,0.00
TOPUP,Current,2024-10-04 11:57:51,2024-10-04 11:57:53,Apple Pay Top-Up by *0722,912.00,0.00,SEK,COMPLETED,912.00
EXCHANGE,Current,2024-10-04 12:03:03,2024-10-04 12:03:03,Exchange to EUR,-912.00,0.00,SEK,COMPLETED,0.00
TRANSFER,Current,2024-10-07 23:28:37,2024-10-07 23:28:37,Transfer from Revolut user,80.00,0.00,SEK,COMPLETED,80.00
EXCHANGE,Current,2024-10-07 23:40:01,2024-10-07 23:40:01,Exchange to EUR,-80.00,0.00,SEK,COMPLETED,0.00
TOPUP,Current,2024-10-08 00:08:46,2024-10-08 00:08:48,Apple Pay Top-Up by *0722,131.38,0.00,SEK,COMPLETED,131.38
EXCHANGE,Current,2024-10-08 00:09:01,2024-10-08 00:09:01,Exchange to EUR,-131.38,0.00,SEK,COMPLETED,0.00
EXCHANGE,Current,2024-10-08 00:19:59,2024-10-08 00:19:59,Exchange to SEK,91.01,0.00,SEK,COMPLETED,91.01
TRANSFER,Current,2024-10-08 00:20:20,2024-10-08 00:20:20,Transfer to Revolut user,-80.00,0.00,SEK,COMPLETED,11.01
EXCHANGE,Current,2024-10-09 14:47:35,2024-10-09 14:47:35,Exchange to EUR,-11.01,0.00,SEK,COMPLETED,0.00
TOPUP,Current,2024-10-15 14:50:04,2024-10-15 14:50:06,Apple Pay Top-Up by *3659,2000.00,0.00,SEK,COMPLETED,2000.00
TOPUP,Current,2024-10-15 14:50:22,2024-10-15 14:50:24,Apple Pay Top-Up by *3659,2000.00,0.00,SEK,COMPLETED,4000.00
TOPUP,Current,2024-10-15 14:51:02,2024-10-15 14:51:04,Apple Pay Top-Up by *3659,2497.00,0.00,SEK,COMPLETED,6497.00
EXCHANGE,Current,2024-10-15 14:51:14,2024-10-15 14:51:14,Exchange to EUR,-6497.00,0.00,SEK,COMPLETED,0.00
TOPUP,Current,2024-10-26 09:16:17,2024-10-26 09:16:19,Apple Pay Top-Up by *0722,218.00,0.00,SEK,COMPLETED,218.00
EXCHANGE,Current,2024-10-26 09:17:45,2024-10-26 09:17:45,Exchange to EUR,-218.00,0.00,SEK,COMPLETED,0.00
FEE,Current,2024-11-01 01:46:57,2024-11-01 01:46:57,Metal plan fee,-169.99,0.00,SEK,COMPLETED,-169.99
EXCHANGE,Current,2024-11-01 01:52:03,2024-11-01 01:52:03,Exchange to SEK,8.56,0.00,SEK,COMPLETED,-161.43
EXCHANGE,Current,2024-11-01 01:54:56,2024-11-01 01:54:56,Exchange to SEK,115.69,0.00,SEK,COMPLETED,-45.74
EXCHANGE,Current,2024-11-01 01:55:53,2024-11-01 01:55:53,Exchange to SEK,34.70,0.00,SEK,COMPLETED,-11.04
EXCHANGE,Current,2024-11-01 01:59:06,2024-11-01 01:59:06,Exchange to SEK,10.99,0.00,SEK,COMPLETED,-0.05
TOPUP,Current,2024-11-02 15:32:22,2024-11-02 15:32:24,Apple Pay Top-Up by *0722,232.00,0.00,SEK,COMPLETED,231.95
EXCHANGE,Current,2024-11-02 15:32:47,2024-11-02 15:32:47,Exchange to EUR,-231.95,0.00,SEK,COMPLETED,0.00
TOPUP,Current,2024-11-09 12:29:05,2024-11-09 12:29:07,Apple Pay Top-Up by *3659,1500.00,0.00,SEK,COMPLETED,1500.00
TOPUP,Current,2024-11-09 12:31:16,2024-11-09 12:31:17,Apple Pay Top-Up by *3659,500.00,0.00,SEK,COMPLETED,2000.00
EXCHANGE,Current,2024-11-09 12:54:49,2024-11-09 12:54:49,Exchange to EUR,-2000.00,0.00,SEK,COMPLETED,0.00
TOPUP,Current,2024-11-14 15:11:04,2024-11-14 15:11:07,Top-Up by *7097,1880.00,0.00,SEK,COMPLETED,1880.00
EXCHANGE,Current,2024-11-14 15:11:16,2024-11-14 15:11:16,Exchange to EUR,-1880.00,0.00,SEK,COMPLETED,0.00
TOPUP,Current,2024-11-16 01:50:36,2024-11-16 01:50:38,Apple Pay Top-Up by *3659,600.00,0.00,SEK,COMPLETED,600.00
EXCHANGE,Current,2024-11-16 01:50:55,2024-11-16 01:50:55,Exchange to EUR,-600.00,0.00,SEK,COMPLETED,0.00
TRANSFER,Current,2024-11-17 17:09:48,2024-11-17 17:09:48,Transfer from Revolut user,301.00,0.00,SEK,COMPLETED,301.00
EXCHANGE,Current,2024-11-18 10:26:44,2024-11-18 10:26:44,Exchange to EUR,-301.00,0.00,SEK,COMPLETED,0.00
TOPUP,Current,2024-11-23 14:19:18,2024-11-23 14:19:20,Apple Pay Top-Up by *0722,152.00,0.00,SEK,COMPLETED,152.00
EXCHANGE,Current,2024-11-24 13:09:42,2024-11-24 13:09:42,Exchange to EUR,-52.00,0.00,SEK,COMPLETED,100.00
CARD_PAYMENT,Current,2024-11-23 14:19:47,2024-11-24 15:32:24,bet365,-100.00,0.00,SEK,COMPLETED,0.00
TOPUP,Current,2024-11-25 15:48:48,2024-11-25 15:48:49,Apple Pay Top-Up by *3659,500.00,0.00,SEK,COMPLETED,500.00
EXCHANGE,Current,2024-11-25 15:49:03,2024-11-25 15:49:03,Exchange to EUR,-500.00,0.00,SEK,COMPLETED,0.00
TOPUP,Current,2024-11-28 10:33:27,2024-11-28 10:33:29,Apple Pay Top-Up by *0722,1794.00,0.00,SEK,COMPLETED,1794.00
EXCHANGE,Current,2024-11-28 10:33:42,2024-11-28 10:33:42,Exchange to EUR,-1794.00,0.00,SEK,COMPLETED,0.00
TOPUP,Current,2024-11-29 19:08:23,2024-11-29 19:08:24,Apple Pay Top-Up by *0722,1713.00,0.00,SEK,COMPLETED,1713.00
EXCHANGE,Current,2024-11-29 19:08:58,2024-11-29 19:08:58,Exchange to EUR,-313.00,0.00,SEK,COMPLETED,1400.00
EXCHANGE,Current,2024-11-29 19:14:38,2024-11-29 19:14:38,Exchange to SEK,100.00,0.00,SEK,COMPLETED,1500.00
FEE,Current,2024-12-01 02:57:45,2024-12-01 02:57:45,Metal plan fee,-169.99,0.00,SEK,COMPLETED,1330.01
CARD_PAYMENT,Current,2024-11-30 13:06:43,2024-12-01 13:50:38,Enco,-167.68,1.68,SEK,COMPLETED,1160.65
EXCHANGE,Current,2024-12-01 14:30:04,2024-12-01 14:30:04,Exchange to SEK,50.35,0.50,SEK,COMPLETED,1210.50
CARD_PAYMENT,Current,2024-11-30 10:13:26,2024-12-01 16:23:22,Adobe,-395.00,0.00,SEK,COMPLETED,815.50
CARD_PAYMENT,Current,2024-12-01 11:59:24,2024-12-02 13:43:38,El Corte Inglés,-121.40,1.21,SEK,COMPLETED,692.89
CARD_PAYMENT,Current,2024-12-01 12:03:35,2024-12-02 13:43:58,El Corte Inglés,-59.78,0.60,SEK,COMPLETED,632.51
TRANSFER,Current,2024-12-02 10:20:40,2024-12-02 15:40:26,International Transfer,-132.00,0.00,SEK,COMPLETED,500.51
CARD_PAYMENT,Current,2024-12-01 13:52:56,2024-12-02 16:30:51,bet365,-500.00,0.00,SEK,COMPLETED,0.51
TOPUP,Current,2024-12-03 11:58:18,2024-12-03 11:58:19,Apple Pay Top-Up by *3659,300.00,0.00,SEK,COMPLETED,300.51
EXCHANGE,Current,2024-12-03 11:58:38,2024-12-03 11:58:38,Exchange to EUR,-300.51,0.00,SEK,COMPLETED,0.00
TOPUP,Current,2024-12-04 10:51:54,2024-12-04 10:51:55,Apple Pay Top-Up by *3659,443.00,0.00,SEK,COMPLETED,443.00
EXCHANGE,Current,2024-12-04 20:23:39,2024-12-04 20:23:39,Exchange to EUR,-98.05,0.00,SEK,COMPLETED,344.95
CARD_PAYMENT,Current,2024-12-04 15:58:35,2024-12-05 14:18:31,Panineria,-144.95,0.00,SEK,COMPLETED,200.00
CARD_PAYMENT,Current,2024-12-04 10:52:07,2024-12-05 15:34:28,bet365,-200.00,0.00,SEK,COMPLETED,0.00
TOPUP,Current,2024-12-07 12:22:29,2024-12-07 12:22:30,Apple Pay Top-Up by *0722,194.00,0.00,SEK,COMPLETED,194.00
TOPUP,Current,2024-12-07 12:58:35,2024-12-07 12:58:36,Apple Pay Top-Up by *3659,542.00,0.00,SEK,COMPLETED,736.00
EXCHANGE,Current,2024-12-07 12:59:09,2024-12-07 12:59:09,Exchange to EUR,-736.00,0.00,SEK,COMPLETED,0.00
TRANSFER,Current,2024-12-07 15:42:26,2024-12-07 15:42:26,Transfer from Revolut user,500.00,0.00,SEK,COMPLETED,500.00
EXCHANGE,Current,2024-12-07 16:20:28,2024-12-07 16:20:28,Exchange to EUR,-500.00,0.00,SEK,COMPLETED,0.00
TOPUP,Current,2024-12-07 19:26:29,2024-12-07 19:26:31,Apple Pay Top-Up by *0722,550.00,0.00,SEK,COMPLETED,550.00
EXCHANGE,Current,2024-12-07 19:27:09,2024-12-07 19:27:09,Exchange to EUR,-550.00,0.00,SEK,COMPLETED,0.00
TOPUP,Current,2024-12-07 23:41:29,2024-12-07 23:41:31,Apple Pay Top-Up by *3659,1000.00,0.00,SEK,COMPLETED,1000.00
EXCHANGE,Current,2024-12-07 23:42:35,2024-12-07 23:42:35,Exchange to EUR,-1000.00,0.00,SEK,COMPLETED,0.00
TOPUP,Current,2024-12-07 23:43:33,2024-12-07 23:43:34,Apple Pay Top-Up by *3659,457.00,0.00,SEK,COMPLETED,457.00
EXCHANGE,Current,2024-12-07 23:50:38,2024-12-07 23:50:38,Exchange to EUR,-457.00,0.00,SEK,COMPLETED,0.00
CARD_CREDIT,Current,2024-12-08 17:27:51,2024-12-08 17:27:51,Spooniker,100.00,0.00,SEK,COMPLETED,100.00
EXCHANGE,Current,2024-12-08 17:28:24,2024-12-08 17:28:24,Exchange to EUR,-100.00,0.00,SEK,COMPLETED,0.00
TOPUP,Current,2024-12-11 11:52:06,2024-12-11 11:52:07,Apple Pay Top-Up by *3659,1089.00,0.00,SEK,COMPLETED,1089.00
EXCHANGE,Current,2024-12-11 11:54:23,2024-12-11 11:54:23,Exchange to EUR,-1089.00,0.00,SEK,COMPLETED,0.00
TOPUP,Current,2024-12-21 00:31:57,2024-12-21 00:31:58,Apple Pay Top-Up by *3659,700.00,0.00,SEK,COMPLETED,700.00
EXCHANGE,Current,2024-12-21 00:32:09,2024-12-21 00:32:09,Exchange to EUR,-700.00,0.00,SEK,COMPLETED,0.00
TOPUP,Current,2024-12-23 10:02:43,2024-12-23 10:02:45,Apple Pay Top-Up by *0722,2000.00,0.00,SEK,COMPLETED,2000.00
CARD_PAYMENT,Current,2024-12-23 11:18:36,2024-12-24 10:37:11,Mercadona,-429.86,0.00,SEK,COMPLETED,1570.14
CARD_PAYMENT,Current,2024-12-23 12:25:46,2024-12-24 10:41:06,Palma Bread,-46.14,0.00,SEK,COMPLETED,1524.00
TRANSFER,Current,2024-12-24 11:55:59,2024-12-24 11:56:00,"Revolut Bank UAB, Sucursal en España",-100.00,0.00,SEK,COMPLETED,1424.00
CARD_PAYMENT,Current,2024-12-25 00:41:37,,Uber,-130.04,0.00,SEK,REVERTED,
TOPUP,Current,2024-12-25 03:03:42,2024-12-25 03:03:43,Apple Pay Top-Up by *0722,2000.00,0.00,SEK,COMPLETED,3424.00
EXCHANGE,Current,2024-12-25 03:03:57,2024-12-25 03:03:57,Exchange to EUR,-2716.72,0.00,SEK,COMPLETED,707.28
CARD_PAYMENT,Current,2024-12-24 16:47:04,2024-12-25 09:29:41,Estanc Palma,-57.99,0.00,SEK,COMPLETED,649.29
CARD_PAYMENT,Current,2024-12-24 10:49:09,2024-12-25 10:14:22,Mistral Coffee House,-77.33,0.00,SEK,COMPLETED,571.96
CARD_PAYMENT,Current,2024-12-25 01:56:57,2024-12-26 09:53:15,EPIC Palma,-480.98,0.00,SEK,COMPLETED,90.98
CARD_PAYMENT,Current,2024-12-25 02:55:15,2024-12-26 09:53:53,Taxi 1071 Palma,-90.98,0.00,SEK,COMPLETED,0.00
TOPUP,Current,2024-12-29 14:14:38,2024-12-29 14:14:39,Apple Pay Top-Up by *3659,1205.00,0.00,SEK,COMPLETED,1205.00
EXCHANGE,Current,2024-12-29 14:14:55,2024-12-29 14:14:55,Exchange to EUR,-1205.00,0.00,SEK,COMPLETED,0.00
TOPUP,Current,2024-12-30 11:25:45,2024-12-30 11:25:46,Apple Pay Top-Up by *3659,1205.00,0.00,SEK,COMPLETED,1205.00
TOPUP,Current,2024-12-30 11:26:01,2024-12-30 11:26:02,Apple Pay Top-Up by *3659,1205.00,0.00,SEK,COMPLETED,2410.00
TOPUP,Current,2024-12-30 11:26:16,2024-12-30 11:26:17,Apple Pay Top-Up by *3659,1205.00,0.00,SEK,COMPLETED,3615.00
TOPUP,Current,2024-12-30 11:26:35,2024-12-30 11:26:36,Apple Pay Top-Up by *3659,1205.00,0.00,SEK,COMPLETED,4820.00
TOPUP,Current,2024-12-30 11:27:03,2024-12-30 11:27:04,Apple Pay Top-Up by *3659,180.00,0.00,SEK,COMPLETED,5000.00
TRANSFER,Current,2024-12-30 11:27:21,2024-12-30 11:27:22,"Revolut Bank UAB, Sucursal en España",-5000.00,0.00,SEK,COMPLETED,0.00
TOPUP,Current,2024-12-30 15:59:47,2024-12-30 15:59:48,Apple Pay Top-Up by *3659,400.00,0.00,SEK,COMPLETED,400.00
EXCHANGE,Current,2024-12-30 15:59:57,2024-12-30 15:59:57,Exchange to EUR,-400.00,0.00,SEK,COMPLETED,0.00
TOPUP,Current,2024-12-30 19:49:07,2024-12-30 19:49:08,Apple Pay Top-Up by *3659,250.00,0.00,SEK,COMPLETED,250.00
EXCHANGE,Current,2024-12-30 19:50:03,2024-12-30 19:50:03,Exchange to EUR,-250.00,0.00,SEK,COMPLETED,0.00
TOPUP,Current,2024-12-31 19:28:33,2024-12-31 19:28:34,Apple Pay Top-Up by *3659,1000.00,0.00,SEK,COMPLETED,1000.00
EXCHANGE,Current,2024-12-31 19:28:48,2024-12-31 19:28:48,Exchange to EUR,-1000.00,0.00,SEK,COMPLETED,0.00
